Gg, Gg, Gg, Gg, Gg, Gg, Gg, Gg, Gg, Gg, Gg, Gg, Gg, Gg, Gg, Gg, Gg, Gg, Gg, Gg, Gg, Gg, Gg, Gg, Gg, Hh, Hh, Hh, Hh, Hh, Hh, Gg, Gg, Gg, Gg
Gg, Gg, Gg, Gg, Ce, Ce, Ce, Gg, Gg, Gg, Gg, Gg, Gg, Gg, Gg, Gg, Hh, Gg, Gg, Gg, Rd, Gg, Gg, Gg, Rd, Hh, Rd, Gg, Hh, Gg, Gg, Hh, Hh, Gg, Gg
Gg, Gg, Gg, Gg, Ce, 1 Ke, Ce, Gg, Gg, Gg, Gg, Gg, Gg, Rd, Hh, Hh, Gg, Re, Re, Gg^Wm, Gg, Rd, Rd, Rd, Gg, Rd, Gg, Rd, Gg, Rd, Rd, Gg, Gg, Gg, Gg
Gg, Gg, Re, Re, Gg, Ce, Gg, Gg, Gg, Gg, Re, Gg, Re, Rd, Hh, Gg, Gg^Vh, Gg, Re, Gg, Gg, Gg, Gg, Rd, Gg, Gg, Gg, Rd, Rd, Rd, Rd, Gg, Rd, Gg, Gg
Gg, Re, Re, Gg, Gg, Gg, Rd, Gg, Re, Re, Rd, Re, Hh, Hh, Hh, Gg, Gg, Re, Re, Gg, Gg, Gg, Gs, Rd, Gs, Gs, Gs, Gs, Rd, Gg, Rd, Gg, Hh, Rd, Gg
Gg, Gg, Re, Gg, Gg, Rd, Gg, Re, Gg, Gg, Gg, Rd, Gg, Hh, Hh, Gg, Gs, Gg, Gg, Gg, Gs, Gs, Gg, Gs, Gg, Rd, Gs, Gg, Rd, Rd, Gs, Gg, Gs, Hh, Gg
Gg, Gg, Re, Rd, Gg, Rd, Rd, Rd, Rd, Gg, Rd, Rd, Rd, Rd, Hh, Gs, Gg, Re, Gs, Gs, Gs, Gs, Gs^Fms, Gs^Fms, Gs^Fms, Gs^Fms, Gs^Fms, Gs, Gs^Fms, Gg, Hh, Gs, Hh, Hh, Gg
Gg, Gg, Rd, Re, Rd, Rd, Rd, Rd, Rd, Rd, Rd, Gs^Fp, Gs^Fp, Rd, Rd, Gs, Gg, Gg, Gs^Fp, Gg, Hh, Hh, Gg, Gs^Fms, Re, Re, Gg, Gg, Gs^Fms, Gs^Fms, Gs^Fms, Hh, Hh, Gs, Gg
Gg, Gg, Rd, Gg, Rd, Gg, Hh, Rd, Rd, Rd, Gg, Gg, Gs^Fp, Gg, Rd, Gs, Gs^Fp, Gg^Vh, Gg, Gg, Chr, Gs^Fp, Gs^Fp, Gg, Re, Gg, Gs^Fms, Gs^Fms, Gs, Gs^Fms, Hh, Mm, Mm^Vhh, Gs, Gg
Gg, Rd, Gg, Rd, Hh, Hh, Gg, Gg, Gg, Gg, Gg, Gs^Fp, Gg, Rd, Gs, Gs, Gg, Gs^Fp, Gs^Fp, Chr, 3 Khr, Hh, Hh, Gg, Re, Gs^Fms, Gs^Fp, Gs, Gs, Gs^Fp, Gs^Fms, Mm, Mm, Mm, Gg
Gg, Rd, Rd, Gg, Gs, Hh, Hh, Gg^Vh, Gg, Gg, Re, Gg, Gg, Rd, Gs, Gs, Gg^Vh, Gs^Fp, Gs^Fp, Chr, Hh, Hh, Gs^Fp, Re, Gg, Gs^Fp, Gs, Gs, Gs^Fp, Gs^Fms, Gs^Fms, Gs^Fms, Gs^Fp, Gs^Fp, Gg
Gg, Rd, Rd, Gg, Gs, Gg, Hh, Gg, Gg, Re, Dd^Dr, Gg, Gs^Fp, Gg, Gs, Gs^Fms, Gs^Fms, Gs^Fp, Gs^Fp, Gs^Fp, Gs^Fms, Gs^Fms, Gs^Fp, Re, Gs^Fms, Gs^Fp, Gs, Gs^Fp, Gs^Fp, Gg, Gs^Fms, Gs^Fp, Gs^Fp, Gs^Fp, Gg
Gg, Rd, Gg, Rd, Rd, Hh, Hh, Rd, Gg, Re, Re, Re, Gg, Gs^Fp, Gs^Fms, Gs^Fms, Gs^Fms, Gs^Fp, Gs^Fp, Gs^Fp, Gs^Fms, Gs^Fms, Gg, Gs^Fms, Gs^Fms, Gg^Vh, Gs^Fp, Gs^Fp, Gg, Gs^Fp, Gs^Fms, Gs^Fms, Gs^Fp, Gs^Fp, Gs^Fp
Gg, Gg, Gg, Gg, Gg, Rd, Gs, Gg, Gs^Fp, Gs^Fp, Gg, Gs^Fp, Gg, Gs^Fp, Gg, Gs^Fms, Gg, Gg, Gs^Fp, Gg, Gs^Fp, Gs^Fms, Gs^Fms, Gs^Fms, Gs^Fms, Gs^Fp, Gg, Gs^Fp, Gg, Gs^Fp, Gs^Fms, Gs^Fms, Gs^Fp, Gs^Fp, Gs^Fp
Gg, Gg, Gg, Gg, Gs^Fms, Gs^Fms, Gs^Fms, Gg, Hh, Hh, Hh, Hh, Gs^Fp, Gs^Fp, Hh, Gg, Gs^Fp, Gg, Gg, Gs^Fp, Gg, Gs^Fp, Gg, Gg, Gg, Gs^Fp, Gg, Gg, Gs^Fp, Gs^Fp, Gg, Gs^Fms, Gs^Fms, Gs^Fp, Gg
Gg, Gg, Gg, Gg, Gs^Fms, Gs^Fms, Gs^Fp, Gs^Fms, Gs^Fms, Gs^Fms, Gs^Fms, Gs^Fms, Gs, Gs^Fp, Hh, Hh, Hh, Gs^Fp, Gs^Fp, Gg, Gs^Fp, Gg, Gs^Fp, Gs^Fp, Gs^Fp, Gs^Fp, Gg, Gg^Ve, Gs^Fp, Gg, Gg, Gs^Fms, Gs^Fp, Gs^Fp, Gg
Gg, Gg, Gs^Fms, Gs^Fms, Dd^Dr, Gs^Fp, Gg, Gs^Fp, Gs^Fms, Gs^Fp, Gg, Gs, Gs^Fp, Gs, Gs, Hh, Hh, Gs^Fms, Gs^Fms, Gs^Fp, Gs^Fp, Gs^Fp, Gs^Fp, Gs^Fp, Gg, Gg, Gs^Fp, Gs^Fp, Gs^Fp, Gs^Fp, Gs^Fp, Gs^Fp, Gs^Fp, Gg, Gg
Gs^Fms, Gs^Fms, Gs^Fms, Gs^Fms, Gs^Fp, Gs^Fp, Gs^Fms, Gs^Fms, Gs^Fp, Gg, Gs^Fp, Gg, Ww, Ww^Bw|, Ww, Hh, Ww, Gs^Fp, Gs^Fp, Gs^Fp, Cv, Gs^Fp, Gs^Fp, Gs^Fp, Gs^Fms, Gs^Fms, Gs^Fp, Gg, Gs^Fp, Gs^Fp, Gg, Gs^Fp, Gg, Gg, Gg
Gs^Fms, Gs^Fms, Gs^Fp, Gs^Fp, Ww, Ww, Ww, Ww, Ww, Ww, Ww, Ww, Gs^Fp, Ww^Bw|, Gg, Ww, Ww, Cv, Gs^Fp, Gs^Fp, Re^Uf, Ww, Ww, Ww, Ww, Gs^Fms, Gs^Fp, Gs^Fp, Re^Uf, Gs^Fp, Gs^Fp, Gs^Fp, Gg, Gs^Fp, Gg
Gg, Gg, Ww, Ww, Gs^Fp, Gs^Fp, Gs^Fp, Gs^Fp, Gs^Fp, Gs^Fp, Gs^Fp, Gs^Fp, Dd^Dr, Gs^Fp, Gs^Fp, Gs^Fp, Gg^Ve, Re, Re, Gs^Fp, Gs^Fp, Gs^Fms, Gll^Fdw, Ww, Gg, Ww, Ww, Gs^Fp, Dd^Dr, Gs^Fp, Gs^Fp, Gs^Fp, Gs^Fp, Gs^Fp, Gg
Ww, Ww, Ww, Gs^Fp, Gg, Gs^Fp, Gg, Gg, Gg, Gg, Gg, Gs^Fp, Gg, Gs^Fp, Gs^Fp, Dd^Dr, Rd, Gs^Fp, Re, Gs^Fp, Gll^Fdw, Gs^Fp, Gll^Fdw, Gs^Fms, Gs^Fp, Re^Uf, Re^Uf, Ww, Ww, Ww, Ww, Gs^Fp, Gs^Fp, Gg, Ww
Ww, Ww, Gg, Gg, Gg, Gs^Fp, Re^Uf, Gs^Fp, Gg, Gs^Fp, Gg, Gs^Fp, Gs^Fp, Gs^Fp, Gg, Gs^Fp, Gll^Fdw, Rd, Re, Re, Gs^Fp, Gll^Fdw, Gs^Fp, Gll^Fdw, Gll^Fdw, Re^Uf, Gs^Fp, Gg, Gs^Fp, Re, Gs^Fp, Ww, Ww, Ww, Gg
Gg, Gg, Gs^Fp, Gs^Fp, Gg, Gs^Fp, Gs^Fp, Re^Uf, Re^Uf, Gs^Fp, Gg, Gg, Chr, Hh, Hh, Gll^Fdw, Gs^Fp, Rd, Rd, Re, Gll^Fdw, Re, Re, Re, Re^Uf, Re^Uf, Hh, Hh, Re, Re, Re^Uf, Re, Re, Re, Gg
Gg, Gs^Fp, Gg, Gg, Gg, Gs^Fp, Re^Uf, Re^Uf, Re^Uf, Gs^Fp, Re, Chr, 4 Khr, Chr, Hh, Gs^Fms, Re^Uf, Gll^Fdw, Gll^Fdw, Rd, Hh, Dd^Dr, Gs^Fp, Gs^Fp, Re^Uf, Re^Uf, Gll^Fdw, Gs^Fp, Re, Gll^Fdw, Re^Uf, Gll^Fdw, Re, Re, Gg
Gg, Gs^Fp, Gg, Gg, Gs^Fp, Gs^Fp, Re^Uf, Re, Re, Gs^Fp, Re, Gs^Fp, Re, Gs^Fp, Hh, Re^Uf, Gs^Fp, Gg, Gs^Fp, Gs^Fp, Gs^Fp, Rd, Rd, Gll^Fdw, Gs^Fp, Re^Uf, Re, Re, Gs^Fp, Re, Gll^Fdw, Re^Uf, Gs^Fp, Re, Gg
Gg, Gg, Gs^Fp, Gs^Fp, Gs^Fp, Re^Uf, Gs^Fp, Gs^Fp, Re, Gg, Gll^Fdw, Re, Re, Hh, Gs^Fp, Re, Gs^Fp, Gg^Ve, Gll^Fdw, Gll^Fdw, Re, Re, Rd, Re, Re, Gll^Fdw, Re, Gll^Fdw, Re, Gg^Ve, Re, Re, Re, Re, Gg
Gg, Gg, Gg, Gg, Gs^Fp, Gs^Fp, Gg, Gs^Fp, Gg, Gll^Fdw, Gs^Fp, Gll^Fdw, Re, Gll^Fdw, Gll^Fdw, Re, Gs^Fp, Gs^Fp, Gll^Fdw, Re, Gs^Fp, Re, Re^Uf, Re^Uf, Re, Gs^Fp, Re, Gs^Fp, Re, Gs^Fp, Re, Re, Gs^Fp, Re, Gg
Gg, Gg, Gs^Fp, Gs^Fp, Gs^Fp, Gs^Fp, Gg, Gll^Fdw, Gs^Fp, Dd^Dr, Gll^Fdw, Gs^Fp, Re, Re, Gll^Fdw, Gll^Fdw, Gs^Fp, Re^Uf, Gll^Fdw, Hh, Hh, Re, Re, Re^Uf, Re, Dd^Dr, Gll^Fdw, Gll^Fdw, Re, Re, Re, Re, Re, Re, Gg
Gg, Gg, Gs^Fp, Gs^Fp, Gs^Fp, Gg^Ve, Gs^Fp, Gs^Fp, Gg, Gll^Fdw, Gs^Fp, Gll^Fdw, Gs^Fp, Gs^Fp, Dd^Dr, Re, Gll^Fdw, Re^Uf, Re, Gll^Fdw, Gs^Fp, Hh, Gll^Fdw, Re, Gll^Fdw, Rd, Gll^Fdw, Re, Gll^Fdw, Re, Gll^Fdw, Re, Re, Re, Gg
Gg, Gs^Fp, Gs^Fp, Gs^Fp, Gg, Gs^Fp, Gs^Fp, Gg, Gs^Fp, Gs^Fp, Re, Gll^Fdw, Re, Re, Re, Gs^Fp, Re^Uf, Re^Uf, Re^Uf, Re, Hh, Hh, Gs^Fp, Re, Gll^Fdw, Gll^Fdw, Cud, Cud, Cud, Gll^Fdw, Gll^Fdw, Gll^Fdw, Gll^Fdw, Gll^Fdw, Gs^Fp
Gg, Gs^Fp, Gs^Fp, Gs^Fp, Gs^Fp, Gg, Gg, Gs^Fp, Gs^Fp, Re, Gll^Fdw, Gs^Fp, Gll^Fdw, Gs^Fp, Re, Gll^Fdw, Gs^Fp, Re^Uf, Gll^Fdw, Gs^Fp, Hh, Gs^Fp, Re, Gll^Fdw, Gll^Fdw, Re, Cud, 2 Kh, Cv, Gll^Fdw, Gll^Fdw, Gll^Fdw, Gll^Fdw, Gs^Fp, Gs^Fp
Gs^Fp, Gs^Fp, Gs^Fp, Gg, Gs^Fp, Gs^Fp, Gs^Fp, Gs^Fp, Re, Re, Gs^Fp, Gs^Fp, Re, Re, Re, Re, Gll^Fdw, Re, Gs^Fp, Gs^Fp, Gs^Fp, Gg^Ve, Gs^Fp, Gll^Fdw, Gll^Fdw, Re, Re, Cv, Cv, Gll^Fdw, Gll^Fdw, Gll^Fdw, Gll^Fdw, Gs^Fp, Gg
Gs^Fp, Gs^Fp, Gg, Gs^Fp, Re, Re, Re, Re, Gs^Fp, Re, Re, Re, Re, Gs^Fp, Gll^Fdw, Re, Re, Gs^Fp, Dd^Dr, Gll^Fdw, Gs^Fp, Gs^Fp, Re, Gs^Fp, Gll^Fdw, Gll^Fdw, Re, Gll^Fdw, Gll^Fdw, Gll^Fdw, Gg, Gll^Fdw, Gs^Fp, Gg, Gg
Gg, Gg, Gg, Gg, Gg, Gg, Gg, Gs^Fp, Gg, Gs^Fp, Gg, Gll^Fdw, Gg, Gll^Fdw, Gs^Fp, Gs^Fp, Gg, Gll^Fdw, Gs^Fp, Gll^Fdw, Gg, Gs^Fp, Gs^Fp, Gg, Gs^Fp, Gg, Gg, Gg, Gg, Gll^Fdw, Gg, Gg, Gg, Gg, Gg
